Level 3
2
3
  #####
###ooo#
#     #
# @  ##
# @ @A#
#  ####
#### 