Level 2
1
2
      ####
#######Ao#
# @ @ @@ #
#     ooo#
###   ####
  #####